"filename", "language", "Dart", "comment", "blank", "total"
"/home/mdd/文档/flutter/iot/lib/chat.dart", "Dart", 242, 1, 9, 252
"/home/mdd/文档/flutter/iot/lib/contact.dart", "Dart", 136, 0, 11, 147
"/home/mdd/文档/flutter/iot/lib/example.dart", "Dart", 198, 48, 23, 269
"/home/mdd/文档/flutter/iot/lib/login.dart", "Dart", 172, 0, 13, 185
"/home/mdd/文档/flutter/iot/lib/main.dart", "Dart", 15, 1, 5, 21
"/home/mdd/文档/flutter/iot/lib/mqtt.dart", "Dart", 66, 0, 10, 76
"/home/mdd/文档/flutter/iot/lib/playAudio.dart", "Dart", 20, 0, 3, 23
"/home/mdd/文档/flutter/iot/lib/recordButton.dart", "Dart", 140, 0, 14, 154
"/home/mdd/文档/flutter/iot/lib/register.dart", "Dart", 158, 0, 9, 167
"/home/mdd/文档/flutter/iot/lib/speechRecognize.dart", "Dart", 68, 1, 6, 75
"/home/mdd/文档/flutter/iot/lib/values.dart", "Dart", 17, 4, 1, 22
"Total", "-", 1232, 55, 104, 1391