"filename", "language", "Dart", "comment", "blank", "total"
"/home/mdd/文档/flutter/iot/lib/chat.dart", "Dart", 243, 1, 9, 253
"/home/mdd/文档/flutter/iot/lib/contact.dart", "Dart", 162, 2, 15, 179
"/home/mdd/文档/flutter/iot/lib/example.dart", "Dart", 198, 48, 23, 269
"/home/mdd/文档/flutter/iot/lib/login.dart", "Dart", 171, 0, 13, 184
"/home/mdd/文档/flutter/iot/lib/main.dart", "Dart", 15, 1, 5, 21
"/home/mdd/文档/flutter/iot/lib/mqtt.dart", "Dart", 66, 0, 10, 76
"/home/mdd/文档/flutter/iot/lib/playAudio.dart", "Dart", 19, 0, 3, 22
"/home/mdd/文档/flutter/iot/lib/recordButton.dart", "Dart", 130, 0, 13, 143
"/home/mdd/文档/flutter/iot/lib/register.dart", "Dart", 158, 0, 9, 167
"/home/mdd/文档/flutter/iot/lib/speechRecognize.dart", "Dart", 68, 1, 6, 75
"/home/mdd/文档/flutter/iot/lib/values.dart", "Dart", 21, 4, 1, 26
"Total", "-", 1251, 57, 107, 1415